#######################################
# Syntax Coloring Map For ESATOBC
#######################################

#######################################
# Datatypes (KEYWORD1)
#######################################

ESAT_ADCSClass	KEYWORD1
ESAT_ADCSHousekeepingTelemetryPacketClass	KEYWORD1
ESAT_ADCSTelemetryPacket	KEYWORD1
ESAT_ADCSRunMode	KEYWORD1
ESAT_ADCSTelecommandHandler	KEYWORD1
ESAT_AttitudeTelecommandHandlerClass	KEYWORD1
ESAT_AttitudePIDControllerClass	KEYWORD1
ESAT_AttitudeStateVector	KEYWORD1
ESAT_CoarseSunSensorClass	KEYWORD1
ESAT_DetumbleRunModeClass       KEYWORD1
ESAT_DiagnosticsTelecommandHandlerClass	KEYWORD1
ESAT_FollowMagneticTargetRunModeClass	KEYWORD1
ESAT_FollowSolarTargetRunModeClass	KEYWORD1
ESAT_GyroscopeClass	KEYWORD1
ESAT_MagnetometerClass	KEYWORD1
ESAT_MagnetorquerApplyMaximumTorqueRunModeClass	KEYWORD1
ESAT_MagnetorquerClass	KEYWORD1
ESAT_MagnetorquerControllerClass	KEYWORD1
ESAT_MagnetorquerDemagnetizeRunModeClass	KEYWORD1
ESAT_MagnetorquerEnableRunModeClass	KEYWORD1
ESAT_MagnetorquerSetXPolarityRunModeClass	KEYWORD1
ESAT_MagnetorquerSetYPolarityRunModeClass	KEYWORD1
ESAT_MagnetorquerTelecommandHandlerClass	KEYWORD1
ESAT_StopActuatorsRunModeClass	KEYWORD1
ESAT_StopActuatorsTelecommandHandlerClass	KEYWORD1
ESAT_TachometerClass	KEYWORD1
ESAT_WheelClass	KEYWORD1
ESAT_WheelControllerClass	KEYWORD1
ESAT_WheelSetDutyCycleRunModeClass	KEYWORD1
ESAT_WheelSetSpeedRunModeClass	KEYWORD1
ESAT_WheelTelecommandHandlerClass	KEYWORD1

#######################################
# Methods and Functions (KEYWORD2)
#######################################

#######################################
# Instances (KEYWORD2)
#######################################

ESAT_ADCS	KEYWORD2
ESAT_ADCSHousekeepingTelemetryPacket	KEYWORD2
ESAT_AttitudePIDController	KEYWORD2
ESAT_AttitudeTelecommandHandler	KEYWORD2
ESAT_CoarseSunSensor	KEYWORD2
ESAT_DetumbleRunMode	KEYWORD2
ESAT_DiagnosticsTelecommandHandler	KEYWORD2
ESAT_FollowMagneticTargetRunMode	KEYWORD2
ESAT_FollowSolarTargetRunMode	KEYWORD2
ESAT_Gyroscope	KEYWORD2
ESAT_Magnetometer	KEYWORD2
ESAT_Magnetorquer	KEYWORD2
ESAT_MagnetorquerApplyMaximumTorqueRunMode	KEYWORD2
ESAT_MagnetorquerController	KEYWORD2
ESAT_MagnetorquerDemagnetizeRunMode	KEYWORD2
ESAT_MagnetorquerEnableRunMode	KEYWORD2
ESAT_MagnetorquerSetXPolarityRunMode	KEYWORD2
ESAT_MagnetorquerSetYPolarityRunMode	KEYWORD2
ESAT_MagnetorquerTelecommandHandler	KEYWORD2
ESAT_StopActuatorsRunMode	KEYWORD2
ESAT_StopActuatorsTelecommandHandler	KEYWORD2
ESAT_Tachometer	KEYWORD2
ESAT_Wheel	KEYWORD2
ESAT_WheelPIDController	KEYWORD2
ESAT_WheelSetDutyCycleRunMode	KEYWORD2
ESAT_WheelSetSpeedRunMode	KEYWORD2
ESAT_WheelTelecommandHandler	KEYWORD2

#######################################
# Constants (LITERAL1)
#######################################
